:: Code couleur des caractères ::
                         R     V     B
BLANC.................. 229 / 229 / 229
NOIR................... 036 / 036 / 036
ROUGE.................. 180 / 012 / 012
BLEU................... 030 / 100 / 160
JAUNE.................. 224 / 165 / 022
VERT................... 107 / 160 / 030