0000000000
0111101150
0121101110
0111111210
0111101110
0000100000
0331101110
0321201210
0311111110
0000000000
